1111111111111
1C0100P0010C1
1000000000001
111100C001111
1000000001001
1C0100E0010C1
1111111111111