11111
1P0C1
101
1C0E1
11111