111111111111111111
1C00000010000000C1
100111000001110001
100000000000000001
1P0000000E00000001
100111000000011101
1C00000010000000C1
111111111111111111