11111
1P0C1
10101
1C001
11111