11111
1P001
10101
100E1
11111