11111
1P0C1
10101
1C0P1
11111