11111
1P0C1
1X101
1C0E1
11111