1111111
1P00001
10C1C01
1001001
1011C01
1C000E1
1111111