111111111111111
1000000000000C1
101111011111101
1C010C0100000E1
101111011011111
1P0000010C00001
111111111111111